1,1,1,1,1,1,1,1,1,1,1,1,1,1,1,1,1,1,1,1,1,1,1,1,1
1, , , , , , , ,1, ,k, , ,1, , ,1, , , ,1, , , ,1
1, , , , , , , ,1, , , , ,d, , ,d, , , ,1, , , ,1
1, , , , , , , ,1, , , , ,1, , ,1, , , ,1, , , ,1
1, , , , , , , ,1, , , , ,1, , ,1, , , ,1, , , ,1
1,1,1,1,1,d,1,1,1,1,1,1,1,1, , ,1,1,d,1,1,1,d,1,1
1, , ,1, , , , , , , , , , , , ,1, , , ,d, , , ,1
1, , ,1, , , , ,1, , , , , , , ,1, , , ,1, , , ,1
1, , ,d, , , , ,1, , , , , , , ,1, , , ,1, , , ,1
1, , ,1,1,1,1,1,1,1,1,1,1,1,1,1,1, , , ,1, , , ,1
1, , ,1, , , , , , , ,1, , , ,1, , , , ,1, , , ,1
1, , ,1, , , , , , , ,1, , , ,1, , , , ,1, , , ,1
1, , ,1, , , ,1, , , ,1,d,1,1,1,1,1,1,d,1,1,1,1,1
1, , ,d, , , ,1, , , , , , ,1, , , , , , , , , ,1
1,1,1,1, , , ,1, , , , , , ,d, , , , , , , , , ,1
1, , ,1, , , ,1, , , , , , ,1, , , , , , , , , ,1
1, , ,1, , ,1,1,1,1,1,1,1,1,1,1,1,1,1,8,1,1,1,1,1
 , , ,1, , , , , , , , ,d, , ,1,1,1, , ,1, , , ,1
1, , ,1, , , , , , , , ,1, , ,1,1,1, , ,1, ,b, ,e
1, , ,1, , , , , , , , ,1, , ,1,1,1, , ,1, , , ,1
1, , ,1,1,1,1,1,1, , , ,1, , ,1,1,1, , ,1, , , ,1
1, , , , , , , , , , , ,1,1,1,1,1,1, , ,1, , , ,1
1, , , , , , , , , , , ,1,1,1,1,1,1, , , , , , ,1
1, , , , , , , , , , , ,1,1,1,1,1,1, , , , , , ,1
1,1,1,1,1,1,1,1,1,1,1,1,1,1,1,1,1,1,1,1,1,1,1,1,1
